#########I###########
#         #   #     #
# ####  # ### # ### #
#             #   # #
# ##### #     ##### #
# #     # #   #     #
# ### ### #  ## # # #
#   # #   #     # # #
### # # ###  #### # #
#   # # #         # #
# ### # #   ##### # #
# #           # # # #
# #  ######## # # # #
# #     #   # #   # #
# #  #### # # ##### #
# #   #   # # #   # #
# #   # # ### ### # #
# #   # # #   #   # #
# #  ## # # ### ### #
# #         #       #
##########O#########
